














NO                                                                  photos_2022_5_17_fst_brick-wall-red-old-_1_.xpm
SO      photos_2022_5_17_fst_brick-wall-red-old-_1_.xpm                   
C       0,200,255
EA                   photos_2022_5_17_fst_brick-wall-red-old-_1_.xpm
F       153, 153, 153
                    WE      photos_2022_5_17_fst_brick-wall-red-old-_1_.xpm

        1111111111 111111111111111
        1000000001100000000000001
        1011000001110000000000001
        1001000000000000000000001
111111111011000001110000111110001
100000000011000001110101111111111
11110111111111011100000010001
11110111111111011101010010001
10000000110101011100000010001
10000000E00000001100000010001
10000001110000011110100110001
11110111 1110101 111110100111
11111111111111111 111111111