









    EA                    
WE      we.xpm



F      153, 153, 200


NO     no.xpm
SO      so.xpm                   
C 0, 250, 255,

        11111111111111111111111111
        10000000011000000000000001
        10110000011100000000000011
        1001000000000000000000001
        1111111111111000000111111
111111111111111111100000000000011      
10000000001100000111000001111111        
11110111111111011100000000001
11110111111111011101010010001
10000010110101011100000010001
1000001N000000011000000100111
10000011110000011110100110001
11110111 1110101 111110100111
11111111111111111 111111111